############################################
#                    #                   #
#   ####   ######   #   #######   ####   #
#   #  #   #    #   #   #     #   #  #   #
#   ####   ######   #   #######   ####   #
#                                        #


######    #     ############  #          #
     #    #          #        #
     #    ########   #    #####  
     #    #                   #
     #    #      ######### 
######    #      #       #
          #      #       #
######    #      ######### 
          #



