############################################
#                    #                   #
#   ####   ######   #   #######   ####   #
#   #  #   #    #   #   #     #   #  #   #
#   ####   ######   #   #######   ####   #
#                                        #
#                                        #
#                                        #
######    #     ############  #    #######
     #    #          #        #    #
     #    ########   #    #####    #
     #    #                   #    #
     #    #      #########    #    #
######    #      #       #    #    #######
          #      #       #    #          
######    #      #########    #    #######
          #                   #    #
          #                   #    #



